Rooms
An Interactive Fiction by Gerardo Perez
Release 1 / Serial number 130312 / Inform 7 build 6G60 (I6/v6.32 lib 6/12N) SD

foyer

>lok
That's not a verb I recognise.

* * *

Rooms
An Interactive Fiction by Gerardo Perez
Release 1 / Serial number 130312 / Inform 7 build 6G60 (I6/v6.32 lib 6/12N) SD

foyer

>s
basement
A huge basement that gives off some bad vibes. It seems like the most unlikely escape from this prison, but there must be some clues around. The first thing you notice is large steel cage, its door swong wide open.  The cage rests in a corner. You can also see a damaged old painting on the wall, some old boxes from which a hint of moonlight seems to be peering in, and a table with various medical utilities.

You can see a box and a painting here.

>look
basement
A huge basement that gives off some bad vibes. It seems like the most unlikely escape from this prison, but there must be some clues around. The first thing you notice is large steel cage, its door swong wide open.  The cage rests in a corner. You can also see a damaged old painting on the wall, some old boxes from which a hint of moonlight seems to be peering in, and a table with various medical utilities.

You can see a box and a painting here.

>n
foyer

* * *

>s
basement
A huge basement that gives off some bad vibes. It seems like the most unlikely escape from this prison, but there must be some clues around. The first thing you notice is large steel cage, its door swong wide open.  The cage rests in a corner. You can also see a damaged old painting on the wall, some old boxes from which a hint of moonlight seems to be peering in, and a table with various medical utilities.

You can see a box and a painting here.

>s
study
You can tell the Doctor spends much of his time here. There are two bookshelves, a small desk covered with neat piles of papers, and a chair. You can also see a cabinet with glass doors. Something is faintly reflecting light in there.

You can see a cabinet (in which is a yellow gem) here.

>x cabinet
There's a  small lock on the cabinet, although the doors seem to be made of fragile glass.

In the cabinet is a yellow gem.

>break cabinet
it breaks.

>smash cabinet
it breaks.

>attack ear
You can't see any such thing.

* * *

>att cabinet
That's not a verb I recognise.

>attack cabinet
it breaks.

>break cabinet
it breaks.

>break door
You can't see any such thing.

>break cabinet
it breaks.

>break gem
no.

>open cabinet
That's not something you can open.

>kill cabinet
it breaks.