Suddenly, all of the windows are slammed shut and barricaded.
You hear a click on the front door.
 As you stand there, trying to collect yourself, another loud bang shakes you up. Someone or something is coming upstairs. Something big.

Dr. Redrum's Cuckoo Mansion of Despair
An Interactive Fiction by Gerardo Perez and Adam Wardell
Release 1 / Serial number 130315 / Inform 7 build 6G60 (I6/v6.32 lib 6/12N) SD

Kitchen & Dining Room
A large kitchen and dining combination room. There is a fine stone-top counter separating the kitchen from the rest of the room. There are some dish cabinets with nothing but kitchen utensils inside.

On the dining table is fake fruit.

>lok
That's not a verb I recognise.

>look
foyer

* * *

>s
You can't go that way.

>look
armory
This room is lined with gun racks. Too bad they're all empty, as if the place had been robbed. There is also a locker to the left of the room and lots of ammo boxes strewn around.

You can see ammo boxes here.

>n
foyer

>a
That's not a verb I recognise.

>s
basement
 The cage rests in a corner. You can also see a damaged old painting on the wall, some old boxes from which a hint of moonlight seems to be peering in, and a table with various medical utilities.

You can see a box and a painting here.

>x painting
A painting of the deep blue sea melding with a beatiful red sunset.

>take painintg
You can't see any such thing.

>take painting
Taken.

* * *

>look
armory
This room is lined with gun racks. Too bad they're all empty, as if the place had been robbed. There is also a locker to the left of the room and lots of ammo boxes strewn around.

You can see ammo boxes here.

>look
armory
This room is lined with gun racks. Too bad they're all empty, as if the place had been robbed. There is also a locker to the left of the room and lots of ammo boxes strewn around.

You can see ammo boxes here.

>go up
You can't go that way.

>go down
You can't go that way.

>go down
You can't go that way.

>go up
You can't go that way.

>go up
You can't go that way.

>x armory
You can't see any such thing.

>x locker
You see nothing special about the locker.

>take gun
You can't see any such thing.

>open locker
You open the locker, revealing gun cleaning equipment and a small pistol.

>take ammo
You notice.

Taken.

>take gun
Which do you mean, gun cleaning equipment or the small pistol?

>i
You are carrying:
  ammo boxes

>take pistol
That bastard must have forgotten about this one.

Taken.

I beg your pardon?

* * *

>s
You can't go that way.

>s
Study
You can tell the Doctor spends much of his time here. There are two bookshelves, a small desk covered with neat piles of papers, and a chair. You can also see a cabinet with glass doors. Something is faintly reflecting light in there.

>x cabinet
There's a  small lock on the cabinet, although the doors seem to be made of fragile glass.

>break cabinet
You break the cabinet with a loud crash.

>smash cabinet
Violence isn't the answer to this one.

>attack ear
You can't see any such thing.

>att cabinet
That's not a verb I recognise.

>attack cabinet
Violence isn't the answer to this one.

>break cabinet
I can't break that.

You break the cabinet with a loud crash.

>break door
You can't see any such thing.

>break cabinet
I can't break that.

You break the cabinet with a loud crash.

>break gem
You can't see any such thing.

>open cabinet
You open the cabinet, revealing a yellow gem.

>kill cabinet
Violence isn't the answer to this one.

* * *

>s
Study
You can tell the Doctor spends much of his time here. There are two bookshelves, a small desk covered with neat piles of papers, and a chair. You can also see a cabinet with glass doors. Something is faintly reflecting light in there.

>look
Study
You can tell the Doctor spends much of his time here. There are two bookshelves, a small desk covered with neat piles of papers, and a chair. You can also see a cabinet with glass doors. Something is faintly reflecting light in there.

>break gem
You can't see any such thing.

>x gem
You can't see any such thing.

>open cabinet
It seems to be locked.

>break cabinet
You break the glass cabinet with a loud crash.

>break gem
You can't break that.

>break cabinet
It's already broken.

>x gem
A beautiful yellow gem.

>lool
That's not a verb I recognise.

>look
Study
You can tell the Doctor spends much of his time here. There are two bookshelves, a small desk covered with neat piles of papers, and a chair. You can also see a cabinet with glass doors. Something is faintly reflecting light in there.

>break glass
It's already broken.

>n
basement
The cage rests in a corner. You can also see a damaged old painting on the wall, some old boxes from which a hint of moonlight seems to be peering in, and a table with various medical utilities.

A box rests in the corner.

You can also see a painting here.

>insert
I didn't understand that sentence.

>s
Study
You can tell the Doctor spends much of his time here. There are two bookshelves, a small desk covered with neat piles of papers, and a chair. You can also see a cabinet with glass doors. Something is faintly reflecting light in there.

>s
Master Bedroom
There is a rather large bed in the room. Some things you could check are a dresser a closet.

There is a statue resting a the corner of the room.

>x statue
A life-size statue of a man. He shows a serene smile as he holds out both hands. You notice something peculiar about this statue's chest.

>x chest
On its right chest are two octogonal shaped indentations that look like they might have held something..

>n
Study
You can tell the Doctor spends much of his time here. There are two bookshelves, a small desk covered with neat piles of papers, and a chair. You can also see a cabinet with glass doors. Something is faintly reflecting light in there.

>ls
That's not a verb I recognise.

>look
Study
You can tell the Doctor spends much of his time here. There are two bookshelves, a small desk covered with neat piles of papers, and a chair. You can also see a cabinet with glass doors. Something is faintly reflecting light in there.

>break cabinet
It's already broken.

* * *

>s
Master Bedroom
There is a rather large bed in the room. Some things you could check are a dresser a closet.

There is a statue resting a the corner of the room.

>insert gem into statue
You can't see any such thing.

>insert gem into chest
You can't see any such thing.

>look
Master Bedroom
There is a rather large bed in the room. Some things you could check are a dresser a closet.

There is a statue resting a the corner of the room.

>insert gem
I didn't understand that sentence.

>insert gem into chest
You can't see any such thing.

>x statue
A life-size statue of a man. He shows a serene smile as he holds out both hands. You notice something peculiar about this statue's chest.

* * *

>x chest
On its right chest are two octogonal shaped indentations that look like they might have held something..

>i
You are carrying nothing.

* * *

>s
Study
You can tell the Doctor spends much of his time here. There are two bookshelves, a small desk covered with neat piles of papers, and a chair. You can also see a cabinet with glass doors. Something is faintly reflecting light in there.

>open cabinet
It seems to be locked.

* * *

>break cabinet
You break the glass cabinet with a loud crash.

>x cabinet
There's a  small lock on the cabinet, although the doors seem to be made of fragile glass.

In the glass cabinet is the yellow gem.

>take gem
Taken.

>s
Master Bedroom
There is a rather large bed in the room. Some things you could check are a dresser a closet.

There is a statue resting a the corner of the room.

>insert gem into statue
you did it

>take gem
You remove the yellow gem from the statue's chest.

>put gem in statue
you did it

>x chest
List the gems in slots.

>x chest
List the gems in slots.

* * *

>s
Study
You can tell the Doctor spends much of his time here. There are two bookshelves, a small desk covered with neat piles of papers, and a chair. You can also see a cabinet with glass doors. Something is faintly reflecting light in there.

>s
Master Bedroom
There is a rather large bed in the room. Some things you could check are a dresser and a closet.

There is a statue resting a the corner of the room.

You can also see a blue gem here.

>n
Study
You can tell the Doctor spends much of his time here. There are two bookshelves, a small desk covered with neat piles of papers, and a chair. You can also see a cabinet with glass doors. Something is faintly reflecting light in there.

>break canibet
You can't see any such thing.

>break cabinet
You break the glass cabinet with a loud crash.

>take gem
Taken.

>s
Master Bedroom
There is a rather large bed in the room. Some things you could check are a dresser a closet.

There is a statue resting a the corner of the room.

You can also see a blue gem and a red gem here.

>x chest
On its right chest are two octogonal shaped indentations that look like they might have held something..

>put gem in chest
(the yellow gem in the statue's chest)
You insert the yellow gem into the statue's chest. It fits perfectly.

>i
You are carrying nothing.

>take gem
Which do you mean, the yellow gem, the blue gem or the red gem?

>i
You are carrying nothing.

>x gem
Which do you mean, the yellow gem, the blue gem or the red gem?

>x chest
List the gems in slots.

>put gem in chest
Which do you mean, the yellow gem, the blue gem or the red gem?

>x chest
List the gems in slots.

>take gem
Which do you mean, the yellow gem, the blue gem or the red gem?

>x chest
List the gems in slots.

>take gem from chest
Which do you mean, the yellow gem, the blue gem or the red gem?

>all
Sorry, you can only have one item here. Which exactly?

>take yellow gem
You remove the yellow gem from nothing.

* * *

>s
Master Bedroom
There is a rather large bed in the room. Some things you could check are a dresser and a closet.

There is a statue resting a the corner of the room.

You can also see a blue gem here.

>take red gem
You can't see any such thing.