Suddenly, all of the windows are slammed shut and barricaded.
You hear a click on the front door.
 As you stand there, trying to collect yourself, another loud bang shakes you up. Someone or something is coming upstairs. Something big.

Den Entryway Bukkake
Godzilla Mothra Megaraptor
Skeletor Armory Bathroom One
Guest Room First Floor Corridor Kitchen & Dining Room

Bathroom Two Connecticut New Jersey
Delaware Bedroom A Maryland
Carolina New York Virginia
Bedroom B Second Floor Corridor Pennsylvania

Dr. Redrum's Cuckoo Mansion of Despair
An Interactive Fiction by Gerardo Perez and Adam Wardell
Release 1 / Serial number 130315 / Inform 7 build 6G60 (I6/v6.32 lib 6/12N) SD

Mansion Grounds
Some initial description of the grounds goes here!

You can see a front door here.

>n
Bee6
Waxy, translucent walls surround you on six sides; the floor and ceiling are made of the same material, gently uneven. There are exits in every direction, cut into the faces or the corners.

>s
Bee4
Waxy, translucent walls surround you on six sides; the floor and ceiling are made of the same material, gently uneven. There are exits in every direction, cut into the faces or the corners.

>e
You can't go that way.

>w
You can't go that way.

* * *

>s
Bee4
Waxy, translucent walls surround you on six sides; the floor and ceiling are made of the same material, gently uneven. There are exits in every direction, cut into the faces or the corners.

>go north
You can't go that way.

>n
You can't go that way.

>s
You can't go that way.

>look
Entry Hall

* * *

>s
Bee4
Waxy, translucent walls surround you on six sides; the floor and ceiling are made of the same material, gently uneven. There are exits in every direction, cut into the faces or the corners.

>s
Bee4
Waxy, translucent walls surround you on six sides; the floor and ceiling are made of the same material, gently uneven. There are exits in every direction, cut into the faces or the corners.

>n
Hexagonal Room
Waxy, translucent walls surround you on six sides; the floor and ceiling are made of the same material, gently uneven. There are exits in every direction, cut into the faces or the corners.

>n
Hexagonal Room
Waxy, translucent walls surround you on six sides; the floor and ceiling are made of the same material, gently uneven. There are exits in every direction, cut into the faces or the corners.

>s
Hexagonal Room
Waxy, translucent walls surround you on six sides; the floor and ceiling are made of the same material, gently uneven. There are exits in every direction, cut into the faces or the corners.

* * *

>s
Bee4
Waxy, translucent walls surround you on six sides; the floor and ceiling are made of the same material, gently uneven. There are exits in every direction, cut into the faces or the corners.

>n
Bee4
Waxy, translucent walls surround you on six sides; the floor and ceiling are made of the same material, gently uneven. There are exits in every direction, cut into the faces or the corners.

>w
Bee7
Waxy, translucent walls surround you on six sides; the floor and ceiling are made of the same material, gently uneven. There are exits in every direction, cut into the faces or the corners.

>e
Bee2
Waxy, translucent walls surround you on six sides; the floor and ceiling are made of the same material, gently uneven. There are exits in every direction, cut into the faces or the corners.

>e
Bee1
Waxy, translucent walls surround you on six sides; the floor and ceiling are made of the same material, gently uneven. There are exits in every direction, cut into the faces or the corners.

>e
Bee1
Waxy, translucent walls surround you on six sides; the floor and ceiling are made of the same material, gently uneven. There are exits in every direction, cut into the faces or the corners.

>n
Bee6
Waxy, translucent walls surround you on six sides; the floor and ceiling are made of the same material, gently uneven. There are exits in every direction, cut into the faces or the corners.

>n
Bee9
Waxy, translucent walls surround you on six sides; the floor and ceiling are made of the same material, gently uneven. There are exits in every direction, cut into the faces or the corners.

>n
Bee4
Waxy, translucent walls surround you on six sides; the floor and ceiling are made of the same material, gently uneven. There are exits in every direction, cut into the faces or the corners.

>n
Bee4
Waxy, translucent walls surround you on six sides; the floor and ceiling are made of the same material, gently uneven. There are exits in every direction, cut into the faces or the corners.

>e
Bee3
Waxy, translucent walls surround you on six sides; the floor and ceiling are made of the same material, gently uneven. There are exits in every direction, cut into the faces or the corners.

>e
Bee7
Waxy, translucent walls surround you on six sides; the floor and ceiling are made of the same material, gently uneven. There are exits in every direction, cut into the faces or the corners.

>e
Bee2
Waxy, translucent walls surround you on six sides; the floor and ceiling are made of the same material, gently uneven. There are exits in every direction, cut into the faces or the corners.

* * *

>e
Bee1
Waxy, translucent walls surround you on six sides; the floor and ceiling are made of the same material, gently uneven. There are exits in every direction, cut into the faces or the corners.

I beg your pardon?

I beg your pardon?

>fuck you
I only understood you as far as wanting to fuck.

>drink you
You can't see any such thing.

>elaborate you
That's not a verb I recognise.

>destroy you
You can't see any such thing.

>laugh you
That's not a verb I recognise.

>screw you
You can't see any such thing.

>beautify you
That's not a verb I recognise.

>fuck you
I only understood you as far as wanting to fuck.

>fuck table
I only understood you as far as wanting to fuck.

>attack
What do you want to attack?

>attack myself
Violence isn't the answer to this one.

* * *

>n
Bee6
Waxy, translucent walls surround you on six sides; the floor and ceiling are made of the same material, gently uneven. There are exits in every direction, cut into the faces or the corners.

>n
Hexagonal Room
Waxy, translucent walls surround you on six sides; the floor and ceiling are made of the same material, gently uneven. There are exits in every direction, cut into the faces or the corners.

* * *

>s
Hexagonal Room
Waxy, translucent walls surround you on six sides; the floor and ceiling are made of the same material, gently uneven. There are exits in every direction, cut into the faces or the corners.

>e
Hexagonal Room
Waxy, translucent walls surround you on six sides; the floor and ceiling are made of the same material, gently uneven. There are exits in every direction, cut into the faces or the corners.

>w
Hexagonal Room
Waxy, translucent walls surround you on six sides; the floor and ceiling are made of the same material, gently uneven. There are exits in every direction, cut into the faces or the corners.

* * *

>go east
You can't go that way.

>go west
You can't go that way.

>go up
You can't go that way.

>go fuck yourself
You can't see any such thing.

>fuck you
I only understood you as far as wanting to fuck.

>deplete you
That's not a verb I recognise.

>fuck myself
I only understood you as far as wanting to fuck.

>fuck stuff
I only understood you as far as wanting to fuck.

>fuck
Real adventurers do not use such language.

* * *

>go north
now the new door

>go north
Upper Landing

* * *

>go inside
(first opening the front door)

Entryway
Some initial description of the entryway goes here!

You can see a front door here.

>go south
Tampon

>go north
You can't go that way.

* * *

>go inside
(first opening the front door)

Entryway
Some initial description of the entryway goes here!

You can see a front door here.

>e
Bathroom One
A standard bathroom with a shower, toilet and sink. There is a large mirror with a fancy border near the sink.

You can see a mirror here.

>s
Pantry
A pantry that receives little light. There is a rack that holds unperishable food.

At the end of the room are a few large boxes.

>s
Skeletor

>s
Den
There is a mount of a bear's head on the wall. Beside.

There is a a mount of a bear head on the wall.

>w
First Floor Corridor
You can see the second floor stairs here.

You can see the basement stairs here.

>go up
Second Floor Corridor
You can see the second floor stairs here.

>e
Bedroom A

>n
Virginia

>w
You can't go that way.

>n
Connecticut

>n
Bathroom Two
There is nothing of interest here.

>w
Delaware

>w
New York